###########
#         #
##### ### #
# # # # # #
# # # # # #
#   # # # #
# # # # # #
# #     # #
# ##### # #
#     # # #
###########